████████████████████████████
█············██············█
█·████·█████·██·█████·████·█
█o█  █·█   █·██·█   █·█  █o█
█·████·█████·██·█████·████·█
█··························█
█·████·██·████████·██·████·█
█·████·██·████████·██·████·█
█······██····██····██······█
██████·█████ ██ █████·██████
█    █·█████ ██ █████·█    █
█    █·██          ██·█    █
█    █·██ ███══███ ██·█    █
██████·██ █      █ ██·██████
      ·   █      █   ·      
██████·██ █      █ ██·██████
█    █·██ ████████ ██·█    █
█    █·██          ██·█    █
█    █·██ ████████ ██·█    █
██████·██ ████████ ██·██████
█············██············█
█·████·█████·██·█████·████·█
█·████·█████·██·█████·████·█
█o··██·······  ·······██··o█
███·██·██·████████·██·██·███
███·██·██·████████·██·██·███
█······██····██····██······█
█·██████████·██·██████████·█
█·██████████·██·██████████·█
█··························█
████████████████████████████

Key:
█     Wall
·     Regular pellet
o     Power pellet
══    Ghost-house door
space Empty corridor
